30 30
0   0	0	0	0	0	0	0	0	0	0	0	0	0	0	0	0	0	0	0	0	0	0	0	0	0	0	0	0	0	0   0
0   7	0	0	0	0	0	0	0	0	0	0	0	0	0	7	7	0	0	0	0	0	0	7	0	0	0	0	0	0	7   0
0   7	0	0	0	0	0	0	0	0	0	0	0	0	0	7	7	0	0	7	0	0	0	7	0	0	0	0	0	0	7   0
0   7	0	0	0	0	0	0	7	0	0	0	0	0	0	7	7	0	0	7	0	0	0	7	0	0	0	0	0	0	7   0
0   7	0	0	0	0	0	7	0	0	0	0	0	0	0	7	7	0	0	0	0	0	0	7	0	0	0	0	0	0	7   0
0   7	0	0	0	0	7	0	0	0	0	0	0	0	0	7	7	0	0	0	0	0	0	7	0	0	0	0	0	0	7   0
0   9	5   5   5   5   5	8	0	0	0	0	0	0	0	7	9	5	5	3	5	5	5	8	0	0	0	0	0	0	7   0
0   7	0	0	0	0	7	0	0	0	0	0	0	0	0	7	7	0	0	0	0	0	0	7	0	0	0	0	0	0	7   0
0   7	0	0	0	0	7	0	0	0	0	0	0	0	0	7	7	0	0	0	0	0	0	7	0	0	0	0	0	0	7   0
0   7	0	0	0	0	7	0	0	0	0	0	0	0	0	7	7	0	0	0	0	0	0	7	0	0	0	0	0	0	7   0
0   7	0	0	0	7	0	0	0	0	0	0	0	0	0	7	7	0	0	0	0	0	0	7	0	0	0	0	0	0	7   0
0   9	5	5	5	5	5	5	5	5	5	5	5	5	5	1	1	5	5	5	5	5	5	1	5	5	5	5	5	5	8   0
0   7	0	0	0	0	0	7	0	0	0	0	0	0	0	7	7	0	0	7	0	0	0	7	0	0	0	0	0	0	7   0
0   7	0	0	0	0	0	7	0	0	0	0	0	0	0	7	7	0	0	7	0	0	0	7	0	0	0	0	0	0	7   0
0   7	0	0	0	0	0	7	0	0	0	0	0	0	0	7	7	0	0	7	0	0	0	7	0	0	0	0	0	0	7   0
0   7	0	0	0	0	0	7	0	0	0	0	0	0	0	7	7	0	0	7	0	0	0	7	0	0	0	0	0	0	7   0
0   7	0	0	0	0	0	7	0	0	0	0	0	0	0	7	7	0	0	7	0	0	0	7	0	0	0	0	0	0	7   0
0    7	0	0	0	0	0	7	0	0	0	0	0	0	0	7	7	0	0	7	0	0	0	7	0	0	0	0	0	0	7   0
0   12	5	5	5	5	5	5	5	5	5	5	5	5	5	11	11	5	5	5	5	5	5	11	5	5	5	5	5	5	10  0
0   7	0	0	0	0	0	0	0	0	0	0	0	0	0	7	7	0	0	0	0	0	0	7	0	0	0	0	0	0	7   0
0   7	0	0	0	0	0	0	0	0	0	0	0	0	0	7	7	0	0	0	0	0	0	7	0	0	0	0	0	0	7   0
0   7	0	0	0	0	0	0	0	0	0	0	0	0	0	7	7	0	0	0	0	0	0	7	0	0	0	0	0	0	7   0
0   7	0	0	0	0	0	0	0	0	0	0	0	0	0	7	7	0	0	0	0	0	0	7	0	0	0	0	0	0	7   0
0   7	0	0	0	0	0	7	0	0	0	0	0	0	0	7	7	0	0	7	0	0	0	7	0	0	0	0	0	0	7   0
0   9	5   5   5   5   5	8	0	0	0	0	0	0	0	7	9	5	5	3	5	5	5	8	0	0	0	0	0	0	7   0
0   7	0	0	0	0	0	7	0	0	0	0	0	0	0	7	7	0	0	0	0	0	0	7	0	0	0	0	0	0	7   0
0   7	0	0	0	0	0	7	0	0	0	0	0	0	0	7	7	0	0	0	0	0	0	7	0	0	0	0	0	0	7   0
0   7	0	0	0	0	0	7	0	0	0	0	0	0	0	7	7	0	0	0	0	0	0	7	0	0	0	0	0	0   7   0
0   7	0	0	0	0	0	7	0	0	0	0	0	0	0	7	7	0	0	0	0	0	0	7	0	0	0	0	0	0	7   0
0   9	5	5	5	5	5	5	5	5	5	5	5	5	5	1	1	5	5	10	0	0	0	7	0	0	0	0	0	0	7   0
0   7	0	0	0	0	0	7	0	0	0	0	0	0	0	7	7	0	0	7	0	0	0	7	0	0	0	0	0	0	7   0
0   7	0	0	0	0	0	7	0	0	0	0	0	0	0	7	7	0	0	7	0	0	0	7	0	0	0	0	0	0	7   0
0   7	0	0	0	0	0	7	0	0	0	0	0	0	0	7	7	0	0	7	0	0	0	7	0	0	0	0	0	0	7   0
0   7	0	0	0	0	0	7	0	0	0	0	0	0	0	7	7	0	0	7	0	0	0	7	0	0	0	0	0	0	7   0
0   4	5	5	5	5	5	5	3	5	5	5	5	5	5	4	4	5	5	5	5	5	5	4	5	5	5	5	5	5	4   0
0   0	0	0	0	0	0	0	0	0	0	0	0	0	0	0	0	0	0	0	0	0	0	0	0	0	0	0	0	0	0   0